111111111111
11001E100001
1C0000000001
11000000C001
1000000CPC01
10000000C001
111111111111
