1111111111
11001E1001
1C00000P01
1100000001
1000000C01
1C00000001
1C00000001
1C00000001
1C00000001
1000000001
1111111111