1111111111111
11001E1000001
1000000P00001
1100000000001
1000000C00001
1000000000001
1000000001111
1000000001111
1000000001111
1000000001111
1000000001111
1000000001111
1000000001111
1000000001111
1000000001111
1111111111111